'0','0','0','0','0','3','0','0','0','2','0','0','0','0','0',
'0','1','7','5','0','0','7','4','0','7','0','0','0','0','0',
'0','0','0','7','7','0','8','0','0','0','4','7','0','0','0',
'0','0','0','0','0','1','8','0','0','8','8','8','8','0','0',
'0','0','0','7','0','0','8','6','0','0','0','0','0','0','0',
'0','0','0','7','7','7','7','0','0','0','0','3','0','0','0',
'0','0','0','0','2','0','8','0','0','7','0','0','0','0','0',
'0','0','0','0','0','0','8','6','7','7','5','0','0','0','0',
'0','0','0','0','0','0','7','0','7','0','0','7','0','0','0',
'0','0','0','0','0','0','0','0','0','0','0','1','0','0','0'